scrolling
8
180
1237
physique
80
81
00000000000000000000000000000000010000000000000000100000111111110000000000000000
00000000000000000000000000000000010000000000000000100000000000010000000000000000
00000000000000000000000000000000010000000010000000100000000000010000000000000000
00000000000000000000000011111111110000000000000000100000000000010000000000000000
00000000000000000000000100000000000000000000000000100000000000010000000000000000
00000000000000000001111100000000000000000000000000110001111110010000000000000000
00000000000000111110000000000000000000000000000000000000000010010000000000000000
00000000000001000000000000000000001111000000000000000000000010011111100000000000
00000000001111000000000000000000010000100000000000000000000010000000100000000000
00000000010000001000000000000001100000011100000000000000000010000000100000000000
00000000010000000000000000000011111110000011000000000000000010100000100000000000
00000000010000000000000000000000000001000001000000000000000010000000100000000000
00000000100000000001111110000000001110000000100000100000000010000000100000000000
00000000100000000001000001110000000010000000010000000000000010000000100000000000
00000000100000000001000001010000001100000000001000000000000010000000100000000000
00000000100000000001000000100000001000000000000100000000000010000000100000000000
00000000100000000001000000010000110000000000000011000000000010000000100000000000
00000000100010000001000000010000100000000000000000100000000010000000100000000000
00000000100000000001000000100000100000000000000000011100000010000000100000000000
00000000100000000001000000100011000000000000000000000011111010000000100000000000
00000000100000000001000000100011110000000000000000000001101010000000100000000000
00000000100000000001000000010000010000000000000000000010011010000000100000000000
00000000100000000001000000010000001000000000000000000100010010000000100000000000
00000000100000000001000000100000001000000000000000001000011010000000100000000000
00000000100000000001000000011000000100000000000000001000010110000000100000000000
00000000100000000001000000001000000010000000000000010000001110000000100000000000
00000000100000000001000000001000000010000000000011100000000010000000100000000000
00000000100000000001000000001000000001000000000100000000000010000000100000000000
00000000100000000001000000000100000001000000000010000000000010000000100000000000
00000000100000000001000000000100000000100000001101100000000010000100100000000000
00000000100000000001000000000100000001000000010010010000000010000000100000000000
00000000100000000001000000000010000000100000100001101100000010000000100000000000
00000000101000000001000000000010000000100001000000010010000010000000100000000000
00000000100000000001000000000001000000100010000000010010000010000000100000000000
11111111100000000001000000000001000000100110000000001010000010000000100000000000
00000000000000000001110000000001000000111000000000000110000010000000100000000000
00000000000000000000001000000001000000000000000000000000000010000000111111100000
00000000000000000000001000000001100000000000000000000000000010000000000000100000
00000000000000000000001000000010000000000000000000000000001011100000000000100000
00000000000000000000001000000010000000000000000000000000000000100000000010100000
00000000000000000010001000000001100000000000000000000000000000100000000000100000
00000000000000000000001000000001100000000000000000000000000000100000000000100000
00000000000000000000001000000001000000000000000000000000000000100000000000100000
00010000000000000000001000000000100000000000000000000000000000100000000000100000
00000000000000000010001000000000100000000000000000000000000000100000000000100000
00000000000000000000001000000000100001000000000000000000000000100000100000100000
00000000000000000000001000000000100000000000000000000000000000100000000000111111
00000000100000000000001000000000100000000000000000000000000000100000000000000000
00000000000000000000001000000000100000000000000000000000000000100000000000010000
00000000000000000000001000000000011000000000100000000000000000100000000000000001
00000000000000000000001000000000001000000000000000000000000000100000000000000000
00000000000000000000001000000000001000000000000000000000000000100000000000000000
00000000000000000000001100000000000110000000000000000000000000100000000000000000
00000000000000000000000010000000000001110000000000000000000000100100000000000000
00000000000000000000000011000000000000010000000001000000100000000100000000000000
11111110001111110000000001100000000000010000000000000000000000000100000000000000
00000000000000010000000000100000000000100000000000000000000000000100000000000000
00000000000000010000000000100000000000100000000000000000000000000100000000000100
00000000000000010000000000110000000000100000000000000000000000000100000000000000
00011111000000010000000000010000000000010000000000000000000000000100000000000000
00011111000000011111111000010000000000010000000000000000000000000100000000000000
00011111000000000000001000010000000000001001000000000000000000000100000000000000
00000000000000000000001000010000000000001001000000000000000000000100000000000000
00000000000000000000001000010000000000001001000000000000000000000100000000000000
00000000000000111110001000010000000000000111000000000000000000000100000000000000
00000000000000111110001000010000000000000001000000010000000000000100101111111111
00000000000000111110001000010000000000000001000000000000000000000100001000000000
00000000000000000000001000010000000000000001000000000000000000000100001000000000
00000000000000000000001000010000000000000001000000000000000000000100001000000000
00000000000000000000001000011100000000000001000000000000000000000100001000000000
11111000000000000000001000000100000000000000100110000000000000000100001000000000
11111000000000000000001100000100000000000000100110000000000000000100001000000000
11111000000000000000000010000100000000000000100110000000000000000100001000000000
00000000001111100000000010000100000000000000011010000000000000000111111111000111
00000000001111100000000010000100000000000000000100100000000000000000000000000000
00000000001111100000000010000100000000000000000100100000000000000000000000000000
00000000000000000000000010000100000000000000000011010010000000000000000000000000
00000000000000000000000010000100000000000000000000001110000000000000000000000000
00000000000000000000000010000100000000000000000000000010000000000000000000000000
00000000000000000000000010000100000000000000000000000010000000000000000000000000

eau
00000000000000000000000000000000010000000000000000100000000000010000000000000000
00000000000000000000000000000000010000000000000000100000000000010000000000000000
00000000000000000000000011111111110000000010000000100000000000010000000000000000
00000000000000000000000100000000000000000000000000100000000000010000000000000000
00000000000000000001111100000000000000000000000000100000000000010000000000000000
00000000000000111110000000000000000000000000000000110001111110010000000000000000
00000000000001000000000000000000000000000000000000000000000010011111000000000000
00000000001110000000000000000000000000000000000000000000000010000000100000000000
00000000010000000000000000000000000000000000000000000000000010000000100000000000
00000000010000000000000000000000000000000000000000000000000010000000100000000000
00000000010000000000000000000000000000000000000000000000000010100000100000000000
00000000100000000000000000000000000000000000000000000000000010000000100000000000
00000000100000000000000000000000000000000000000000100000000010000000100000000000
00000000100000000000000000000000000000000000000000000000000010000000100000000000
00000000100000000001111100000000000000000000000000000000000010000000100000000000
00000000100000000001000100000000000000000000000000000000000010000000100000000000
00000000100000000001000100000000000000000000000000000000000010000000100000000000
00000000100010000001000100000000000000000000000000000000000010000000100000000000
00000000100000000001000100000000000000000000000000000000000010000000100000000000
00000000100000000001000100000000000000000000000000000000000010000000100000000000
00000000100000000001000100000000000000000000000000000000000010000000100000000000
00000000100000000001000100000000000000000000000000000000000010000000100000000000
00000000100000000001000100000000000000000000000000000000000010000000100000000000
00000000100000000001000100000000000000000000000000000000000010000000100000000000
00000000100000000001000100000000000000000000000000000000000010000000100000000000
00000000100000000001000100000000000000000000000000000000000010000000100000000000
00000000100000000001000100000000000000000000000000000000000010000000100000000000
00000000100000000001000100000000000000000000000000000000000010000000100000000000
00000000100000000001000100000000000000000000000000000000000010000000100000000000
00000000100000000001000100000000000000000000000000000000000010000100100000000000
00000000100000000001000100000000000000000000000000000000000010000000100000000000
00000000100000000001000100000000000000000000000000000000000010000000100000000000
00000000101000000001000100000000000000000000000000000000000010000000100000000000
11111111100000000001000100000000000000000000000000000000000010000000100000000000
00000000000000000001110011100000000000000000000000000000000010000000100000000000
00000000000000000000001000100000000000000000000000000000000010000000111111000000
00000000000000000000001000011100000000000000000000000000000010000000000000100000
00000000000000000000001000000100000000000000000000000000000010000000000000100000
00000000000000000000001000000100000000000000000000000000001011100000000000100000
00000000000000000000001000000100000000000000000000000000000000100000000010100000
00000000000000000010001000000100000000000000000000000000000000100000000000100000
00000000000000000000001000000100000000000000000000000000000000100000000000100000
00000000000000000000001000000100000000000000000000000000000000100000000000100000
00010000000000000000001000000100000000000000000000000000000000100000000000100000
00000000000000000010001000000100000000000000000000000000000000100000000000100000
00000000000000000000001000000100000001000000000000000000000000100000100000111111
00000000000000000000001000000100000000000000000000000000000000100000000000000000
00000000100000000000001000000100000000000000000000000000000000100000000000000000
00000000000000000000001000000100000000000000000000000000000000100000000000010000
00000000000000000000001000000100000000000000100000000000000000100000000000000001
00000000000000000000001000000100000000000000000000000000000000100000000000000000
00000000000000000000001100000100000000000000000000000000000000100000000000000000
00000000000000000000000010000100000000000000000000000000000000100000000000000000
00000000000000000000000010000011111000000000000000000000000000100100000000000000
00000000000000000000000001000000001000000000000001000000100000000100000000000000
11111110001111110000000000100000001000000000000000000000000000000100000000000000
00000000000000010000000000100000001000000000000000000000000000000100000000000000
00000000000000010000000000100000001000000000000000000000000000000100000000000100
00000000000000010000000000010000001000000000000000000000000000000100000000000000
00011111000000010000000000010000001000000000000000000000000000000100000000000000
00011111000000011111111000010000001000000000000000000000000000000100000000000000
00000000000000000000001000010000001000000000000000000000000000000100000000000000
00000000000000000000001000010000010000000000000000000000000000000100000000000000
00000000000000000000001000010000010000000000000000000000000000000100000000000000
00000000000000111110001000010000010000000000000000000000000000000100000000000000
00000000000000111110001000010000010000000000000000010000000000000100101111111111
00000000000000000000001000010000010000000000000000000000000000000100001000000000
00000000000000000000001000010000010000000000000000000000000000000100001000000000
00000000000000000000001000011000010000000000000000000000000000000100001000000000
00000000000000000000001000000100010000000000000000000000000000000100001000000000
11111000000000000000001000000100010000000000000000000000000000000100001000000000
11111000000000000000001100000100001111111000000000000000000000000100001000000000
00000000000000000000000010000100000000001000000000000000000000000100001000000000
00000000001111100000000010000100000000001000000000000000000000000111111111000111
00000000001111100000000010000100000000001000000000000000000000000000000000000000
00000000000000000000000010000100000000001000000000000000000000000000000000000000
00000000000000000000000010000100000000001000000000000000000000000000000000000000
00000000000000000000000010000100000000001000000000000000000000000000000000000000
00000000000000000000000010000100000000001000000000000000000000000000000000000000
00000000000000000000000010000100000000001001000000000000000000000000000000000000

//
spawn
45
835
10
10
100
10

170
650
11
11
100
10

400
130
12
12
100
10

855
155
11
11
100
10

577
615
10
10
100
10

885
750
11
11
100
10

925
975
10
10
100
10

935
1170
11
11
100
10

1135
855
12
12
100
10
new
//
caisses

330
590

270
930

170
155

515
205

985
30

680
915
//
barrels

135
1075
barrel

313
893
barrel

111
580
barrel

635
30
barrel

479
419
barrel

745
530
barrel
//
arrivee
0
0
//
bossentry
1205
1078
//
jetpacks

785
695
//