scrolling
7
165
920
physique
90
61
000000000000000000000000000000000000000000000000101100000000000000001111100000000000000000
000000000000000000000000000000000000000000000001100100000000000000001111100000000000000000
000000000000000000000000000000000000000000000010000100000000000000001111100000000000000000
000000000000000000000000000000000000000000000010000111111111110000000000000000000000000000
000000000000000000000000000000000000000000011110000000111110010000000000000000000000000000
000000000000000000000000000000000000000000100000000000111110010000000000000000000000000000
000000000000000000000000000000000000000000100000000000111110010000000000000000000000011111
000000000000000000000000000000000000000000100000000000000000011111111111000000000000011111
000000000000000000000000000000000000000111100000000000000000000011111001000000000000011111
001000000000000000000000000000000000001000000000000000000000000011111001000000000000000000
010111111111111111100000000000000000001000000000000000000000000011111001000000000000000000
110000000000000000011110000000000000001000000000000000000000000000000001000000000000000000
000000000000000000000001000000000000001000000000000000000000000000000001011111000000000000
000000000000000000000001111110000000001001111111110000000000000000000001011111000000000000
000000000000000000000000000001000000011001000000010000000000000000000001011111000000000000
000000000000000000000000000001000000100001000000010000000000000000000001000000000000000000
000000000000000000000000000001000000100001000000010000000000000000000001000000000000000000
000000000000000000000000000001000000100001000000011111100111110000000001000000000000000000
111110000111111100000000000001000000100001000000000001000000010000000001000000000000000000
000000000000000100000000000001000000100001000000000001000000010000000001000000000000000000
000000000000000100000000000001000001100001000000000001000000010000000001000000000000000000
000000000000000100000000000001000010000001000000000001000000010000000001000000000000000000
000000000000000100000000000001000010000001100000000001000000011111111111111111110011111111
000000000000000100000000000001000010000000010000000010000000000011000000000000000000000000
000000000000000111111100011111100010000000010000000100000000000100110000000000000000000000
000000000000000000101000000000100010000000010000001000000000000100010000000000000000000000
000000000000000000101000000000100010000000010000011000000000001000010000000000000000000000
000000000000000001001000000000100010000000010000100000000000001000010000000000000000000000
000000000000000010001000000000100010000000010000100000000000000100100000000000000000000000
000000000000000001000110000000100010000000010000100000000000011000100000000000000000000000
000000000000000010000010000000100110000000010000100000000000010001110000000000000000000000
111111100000000010001010000000101000000000010000100000000000100010000000000000000000000000
000000100000000010010110000000101000000000011001000000000000100001000000000000000000000000
000000100000000010100000000000111110000111110101000000000000100001000000000000000000000000
000000100000000100100000000000000000000000010110000000000000100000100000000000000000000000
110000100000000101000000000000000000000000010000000000000000100000100000000000000000000000
001000100000000101000000000000000000000000010000000000000000100000010000000000000000000000
001100100000000101000000000000000000000000010000000000000001010000010000000000000000000000
000010111100011001000000000000000000000000010000000000000001101100010000000000000000000000
000011011100010001000000000000000000000000010000000000000011000010010000000000000000000000
000000100000010000111000000000000000000000010000000000000000000010100000000000000000000000
000000000000010000001000000000000000000000010000000000000000000001000000000000000000000000
000000000000001000000111111000000000000000010000000000000000000001000000000000000000000000
000000000000000100000000001000000000000000010000000000000000000000000000000000000000000000
000000000000000010000000001000000000000000011111111111111110000000000000000000000000000000
000000000000000001100000001000000000000000000000000000000010000000000000000000000000000000
000000000000000000011000001000000000000000000000000000000010000000000000000000000000000000
000000000000000000000100001000000000000000000000000000000010000000000000000000000000000000
000000000000000000000100001000000000000000000000000000000010000000000000000000000000000000
000000000000000000000011001000000000000000000000000000000010000000000000000000000000000000
000000000000000000000000101000000000000000000000000000000010000000000000000000000000000000
000000000000000000000000101000000000000000000000000000000010000000000000000000000000000000
000000000000000000000000101000000000000000000000000000000010000000000000000000000000000000
000000000000000000000000011000000000000000000000000000000011111111111111100000000000000000
000000000000000000000000011000000000000000000000000000000000000000000000100000000000000000
000000000000000000000000101000000000000000000000000000000000000000000000100000000000000000
000000000000000000000001001000000000000000000000000000000000000000000000100000000000000000
000000000000000000000001001000000000000000000000000000000000000000000000100000000000000000
000000000000000000000010001000000000000000000000000000000000000000000000100000000000000000
000000000000000000001100001000000000000000000000000000000000000000000000100000000000000000

eau
000000000000000000000000000000000000000000000001101100000000000000001111100000000000000000
000000000000000000000000000000000000000000000010000100000000000000001111100000000000000000
000000000000000000000000000000000000000000000010000100000000000000000000000000000000000000
000000000000000000000000000000000000000000011110000111111111110000000000000000000000000000
000000000000000000000000000000000000000000100000000000111110010000000000000000000000000000
000000000000000000000000000000000000000000100000000000111110010000000000000000000000000000
000000000000000000000000000000000000000000100000000000000000010000000000000000000000000000
000000000000000000000000000000000000000111100000000000000000011111111111000000000000011111
000000000000000000000000000000000000001000000000000000000000000011111001000000000000000000
001111111111111111100000000000000000001000000000000000000000000011111001000000000000000000
110000000000000000011110000000000000001000000000000000000000000000000001000000000000000000
000000000000000000000001000000000000001000000000000000000000000000000001000000000000000000
000000000000000000000001111110000000001000000000000000000000000000000001011111000000000000
000000000000000000000000000001000000011001111111110000000000000000000001011111000000000000
000000000000000000000000000001000000100001000000010000000000000000000001000000000000000000
000000000000000000000000000001000000100001000000010000000000000000000001000000000000000000
000000000000000000000000000001000000100001000000010000000000000000000001000000000000000000
000000000000000000000000000001000000100001000000001111100111110000000001000000000000000000
111110000111111100000000000001000000100001000000000001000000010000000001000000000000000000
000000000000000100000000000001000001100001000000000001000000010000000001000000000000000000
000000000000000100000000000001000010000001000000000001000000010000000001000000000000000000
000000000000000100000000000001000010000001000000000001000000010000000001000000000000000000
000000000000000100000000000001000010000001100000000001000000011111111111111111110000000000
000000000000000100000000000001000010000000010000000010000000000000000000000000000000000000
000000000000000111111100011111000010000000010000000100000000000000000000000000000000000000
000000000000000000000000000000100010000000010000001000000000000000000000000000000000000000
000000000000000000000000000000100010000000010000011000000000000000000000000000000000000000
000000000000000000000000000000100010000000010000100000000000000000000000000000000000000000
000000000000000000000000000000100010000000010000100000000000000000000000000000000000000000
000000000000000000000000000000100110000000010000100000000000000000000000000000000000000000
000000000000000000000000000000101000000000010000100000000000000000000000000000000000000000
111111100000000000000000000000111000000000010000100000000000000000000000000000000000000000
000000100000000000000000000000100000000000011001000000000000000000000000000000000000000000
000000100000000000000000000000111110000111110111000000000000000000000000000000000000000000
000000100000000000000000000000000000000000010110000000000000000000000000000000000000000000
000000100000000000000000000000000000000000010000000000000000000000000000000000000000000000
000000100000000000000000000000000000000000010000000000000000000000000000000000000000000000
000000100000000000000000000000000000000000010000000000000000000000000000000000000000000000
000000111100011110000000000000000000000000010000000000000000000000000000000000000000000000
000000000000000010000000000000000000000000010000000000000000000000000000000000000000000000
000000000000000011111000000000000000000000010000000000000000000000000000000000000000000000
000000000000000000001000000000000000000000010000000000000000000000000000000000000000000000
000000000000000000001111111000000000000000010000000000000000000000000000000000000000000000
000000000000000000000000001000000000000000010000000000000000000000000000000000000000000000
000000000000000000000000001000000000000000011111111111111110000000000000000000000000000000
000000000000000000000000001000000000000000000000000000000010000000000000000000000000000000
000000000000000000000000001000000000000000000000000000000010000000000000000000000000000000
000000000000000000000000001000000000000000000000000000000010000000000000000000000000000000
000000000000000000000000001000000000000000000000000000000010000000000000000000000000000000
000000000000000000000000001000000000000000000000000000000010000000000000000000000000000000
000000000000000000000000001000000000000000000000000000000010000000000000000000000000000000
000000000000000000000000001000000000000000000000000000000010000000000000000000000000000000
000000000000000000000000001000000000000000000000000000000010000000000000000000000000000000
000000000000000000000000001000000000000000000000000000000011111111111111100000000000000000
000000000000000000000000001000000000000000000000000000000000000000000000100000000000000000
000000000000000000000000001000000000000000000000000000000000000000000000100000000000000000
000000000000000000000000001000000000000000000000000000000000000000000000100000000000000000
000000000000000000000000001000000000000000000000000000000000000000000000100000000000000000
000000000000000000000000001000000000000000000000000000000000000000000000100000000000000000
000000000000000000000000001000000000000000000000000000000000000000000000100000000000000000

//
spawn
65
820
10
10
100
10

265
825
10
10
100
10

75
435
10
10
100
10

240
233
11
11
100
10

420
225
11
11
100
10

600
435
11
11
100
10

540
715
12
12
100
10

800
133
12
12
100
10

1030
777
12
12
100
10

1250
500
10
10
100
10
new
//
caisses

375
655

265
410

19
235

660
385

845
555

1110
141
//
barrels

71
705
barrel

190
350
barrel

315
580
barrel

435
300
barrel

648
661
barrel

1128
521
barrel

1355
610
barrel
//
arrivee
1299
131
//
bossentry
0
0
//
jetpacks

160
823

638
848

1230
738
//