scrolling
6
10
870
physique
128
61
00000000000010000001000000000000000000000000000000000000000000100000000000000000000000000011000100000000000000000000000000000000
00000000000100000111000000000000000000000000000000000000000000111111000000000000000011111100000111111110000000000000000000000000
00000000000100011000000000000000000000000000000000000000000000000001000000000011111100000000000000000001000000000000000000000000
00000000011000100000000000000000000000000000000000000000000000000001000000000010000000000000000000000001000000000000000000000000
00000000010001100000000000000000000000000000000000000000000000000000100000000100000000000000000000000001000000000000000000000000
00000000100010000000000000000000000000000000000000011000000000000000111111111100000000000000000000000001111110000000000000000000
00000000100100000000000000000000000000000000110000101000000000000000000000000000000000000000000000000000000001100000000000000000
00000001001100000000000000000000000000000000110001000110000000000000000000000000000000000000000000000000000000011110111111000000
00000010010000000000000000000000000000000011001101000010000000000000000000000000000000000000000000000000000000000000000000100000
00000010010000000000000000000000000000001100000101000010000000000000000000000000000000000000000000000000000000000000000000111111
00000011100000000000000000000000000000010000000010001110000000000000000000000000000000000000000000000000000000000000000000000000
00000000000000000000000000000000000000010000000000010000000000000000000000000000000000000000000000000000000000000000000000000000
00000000000000000000000000000000000000010000000000010000000000000000000000000000000000000000000000000000000000000000000000000000
10000000000000000000000000000000000000010001000000001111100000000000000000000000000000000000000000000000000000000000000000000000
01100111000000000000000000000000000000011110100000000000100000000000000000000000000000000000000000000000000000000000000000000000
00011000110000101110000000000000000000000000100000000000100000000000000000000000000000000000000000000000000000000000000000000000
00000000010001010100000000000000000000000000110000000001000000000000000001111111111111100000000000000000000000000000000000000000
11100001100010000010000000000000000000000000001000000001000000000000000001000000000000100000000000000000000000000000000000000000
00010110000010000100000000000000000000000000110000000001000000000000000110000000000000011111100000000000000000000000000000000000
00001000000100000101100000000000000000000000001100000010000000000000000100000000000000000000100000000000000000000000111110000000
00000000000101000010010000000000000000000000000010000100000000000111111000000000000000000000011111111110000000000000100010000000
00000000000110100000001000000000000000000000000001001100000000000100000000000000000000000000000000000010000000000000111110000000
00000000000000100000001000000000000000000000000001110000000000011000000000000000000000000000000000000001100000000000000010011111
00000000000000110000010000000000000000000000000000000000000000010000000000000000000000000000000000000000100000000000000000010000
00000000000000010000001110000000000000000000000000000000000001100000000000000000000000000000000000000000011000000000000000011111
00000000000000010100000001000000000000000000000000000000000001000000000000000000000000000000000000000000001000000000000000000000
00000000000000001010000000100000000000000000000000000000000110000000000000000000000000000000000000000000000111100000000000000000
00000000000000000011000000011000000000000000000000000000000100000000000000000000000000000000000000000000000000011111000000000000
00000000000000000000100000001000000000000000000000000000011000000000000000000000000000000000000000000000000000000001000000000000
00000000000000000000100000001000000000000000000000000000010000000000000000000000000000000000000000000000000000011111000000000000
00000000000000000000100000000111000000000000000000000000010000000000000000000000000000000000000000000000000000100000000000000000
00000000000000000001000000000001000000000000000000000000010000000000000000000000000000000000000000000000000000100000000000000000
00000000000000000001000000000001000000000000000000000000010000000000000000000000000000000000000000000000000000100000000000000000
00000000000000000001000000000001000000000000000000000000011100000000000000000000000000000000000000000000000001100000000000000000
00000000000000000001000000000001000000000000000000000000000100000000000000000000000000000000000000000000000010000000000000000000
00000000000000000110000000000001000000000000000000000000000111111111111000000000000000000000011111111111111110000000000000000000
00000000000000000100000000000010000000000000000000000000000000000000000100000000000000000000100000000000000000000000000000000000
00000000000000001000000000000010000000000000000000000000000000000000000111111111111111111111100000000000000000000000000000000000
00000000000000001000000000000010000000000000000000000000000000000000000000000000000000000000000000000000000000000000000000000000
00000000000000001000000000000010000000000000000000000000000000000000000000000000000000000000000000000000000000000000000000000000
00000000000000010000000000000010000000000000000000000000000000000000000000000000000000000000000000000000000000000000000000000000
00000000000000100000000000000110000000000000000000000000000000000000000000000000000000000000000000000000000000000000000000000000
00000000000001000000000000001000000000000000000000000000000000000000000000111111111111100000000000000000000000000000000000000000
00000000000110000000000000001000000000000000000000000000000000000000000000100000000000100000000000000011111000000000000000000000
00000000000100000000000000001000000000000000000000000000000000000000000000100000000000100000000000000010011000000000000000000000
00000000000100000000000000001000000000000000000000000000000000000000000000111000000000011111100000000101100000000000000000000000
00000000000100000000000000011000000000000000000000000000000000000000000000000100000000000000100000000110000000000000000000000000
00000000000100000000000000100000000000000000000000000000000000111111111100000111111111111111100000111001111111100000000000000000
00000001111000000000000000100000000000000000000000000000000011000000000100000000000000000000000001000000000000100000000000000000
00000001000000000000000001100000000000000000000000000000001100000000000011000000000000000000000010000000000000010000000000000000
00000110000000000000000010000000000000000000000000000000010000000000000001000000000000000000000010000000000000001100000000000000
00001000000000000000000010000000000000000000000000000111100000000000000001000000000000000000011100000000000000000100000000000000
00001000000000000000000010000000000000000000000000000100000000000000000000111000000000000000010000000000000000000011100000000000
00110000000000000000000010000000000000000000000000001000000000000000000000000111111111000001100000000000000000000000100000000000
00100000000000000000000110000000000000000000000000001000000000000000000000000000000000111110000000000000000000000000011111000000
00100000000000000000001000000000000000000000000000010000000000000000000000000000000000000000000000000000000000000000000000100000
11000000000000000000001000000000000000000000000000010000000000000000000000000000000000000000000000000000000000000000000000011100
00000000000000000000010000000000000000000000000000100000000000000000000000000000000000000000000000000000000000000000000000000100
00000000000000000000010000000000000000000000000001000000000000000000000000000000000000000000000000000000000000000000000000000100
00000000000000000000100000000000000000000000000010000000000000000000000000000000000000000000000000000000000000000000000000000100


eau
00000000000000000111000000000000000000000000000000000000000000111110000000000000000011111100000111111110000000000000000000000000
00000000000000000000000000000000000000000000000000000000000000000001000000000001111100000000000000000001000000000000000000000000
00000000000000000000000000000000000000000000000000000000000000000001000000000010000000000000000000000001000000000000000000000000
00000000000000000000000000000000000000000000000000000000000000000000100000000100000000000000000000000001000000000000000000000000
00000000000000000000000000000000000000000000000000000000000000000000111111111100000000000000000000000001111110000000000000000000
00000000000000000000000000000000000000000000000000000000000000000000000000000000000000000000000000000000000001100000000000000000
00000000000000000000000000000000000000000000000000000000000000000000000000000000000000000000000000000000000000011111111111000000
00000000000000000000000000000000000000000000000000000000000000000000000000000000000000000000000000000000000000000000000000100000
00000000000000000000000000000000000000000000000000000000000000000000000000000000000000000000000000000000000000000000000000111111
00000000000000000000000000000000000000000000000000000000000000000000000000000000000000000000000000000000000000000000000000000000
00000000000000000000000000000000000000000000000000000000000000000000000000000000000000000000000000000000000000000000000000000000
00000000000000000000000000000000000000000000000000000000000000000000000000000000000000000000000000000000000000000000000000000000
00000000000000000000000000000000000000000000000000000000000000000000000000000000000000000000000000000000000000000000000000000000
00000000000000000000000000000000000000000000000000000000000000000000000000000000000000000000000000000000000000000000000000000000
00000000000000000000000000000000000000000000000000000000000000000000000000000000000000000000000000000000000000000000000000000000
00000000000000000000000000000000000000000000000000000000000000000000000001111111111111100000000000000000000000000000000000000000
00000000000000000000000000000000000000000000000000000000000000000000000001000000000000100000000000000000000000000000000000000000
00000000000000000000000000000000000000000000000000000000000000000000000110000000000000011111100000000000000000000000000000000000
00000000000000000000000000000000000000000000000000000000000000000000000100000000000000000000100000000000000000000000111110000000
00000000000000000000000000000000000000000000000000000000000000000111111000000000000000000000011111111110000000000000111110000000
00000000000000000000000000000000000000000000000000000000000000000100000000000000000000000000000000000010000000000000111110000000
00000000000000000000000000000000000000000000000000000000000000011000000000000000000000000000000000000001100000000000000010011111
00000000000000000000000000000000000000000000000000000000000000010000000000000000000000000000000000000000100000000000000000011111
00000000000000000000000000000000000000000000000000000000000001100000000000000000000000000000000000000000011000000000000000011111
00000000000000000000000000000000000000000000000000000000000001000000000000000000000000000000000000000000001000000000000000000000
00000000000000000000000000000000000000000000000000000000000110000000000000000000000000000000000000000000000111100000000000000000
00000000000000000000000000000000000000000000000000000000000100000000000000000000000000000000000000000000000000011111000000000000
00000000000000000000000000000000000000000000000000000000011000000000000000000000000000000000000000000000000000000001000000000000
00000000000000000000010100000000000000000000000000000000010000000000000000000000000000000000000000000000000000011111000000000000
00000000000000000000000001110000000000000000000000000000010000000000000000000000000000000000000000000000000000100000000000000000
00000000000000000000000001110000000000000000000000000000010000000000000000000000000000000000000000000000000000100000000000000000
00000000000000000000000000000000000000000000000000000000010000000000000000000000000000000000000000000000000000100000000000000000
00000000000000000000000000000000000000000000000000000000011000000000000000000000000000000000000000000000000001100000000000000000
00000000000000000000000000000000000000000000000000000000000100000000000000000000000000000000000000000000000010000000000000000000
00000000000000000000000000000000000000000000000000000000000111111111111000000000000000000000011111111111111110000000000000000000
00000000000000000000000000000000000000000000000000000000000000000000000100000000000000000000100000000000000000000000000000000000
00000000000000000000000000000000000000000000000000000000000000000000000111111111111111111111100000000000000000000000000000000000
00000000000000000000000000000000000000000000000000000000000000000000000000000000000000000000000000000000000000000000000000000000
00000000000000000000000000000000000000000000000000000000000000000000000000000000000000000000000000000000000000000000000000000000
00000000000000000000100000000000000000000000000000000000000000000000000000000000000000000000000000000000000000000000000000000000
00000000000000000000000000000000000000000000000000000000000000000000000000000000000000000000000000000000000000000000000000000000
00000000000000000000000000000000000000000000000000000000000000000000000000000000000000000000000000000000000000000000000000000000
00000000000000000001000000000000000000000000000000000000000000000000000000000000000000000000000000000000000000000000000000000000
00000000000000000000000000000000000000000000000000000000000000000000000000000000000000000000000000000000000000000000000000000000
00000000000000000000000000000000000000000000000000000000000000000000000000000000000000000000000000000000000000000000000000000000
00000000000000000100010000000000000000000000000000000000000000000000000000000000000000000000000000000000000000000000000000000000
00000000000000000000000000000000000000000000000000000000000000000000000000000000000000000000000000000000000000000000000000000000
00000000000000000000000000000000000000000000000000000000000000000000000000000000000000000000000000000000000000000000000000000000
00000000000000010000000000000000000000000000000000000000000000000000000000000000000000000000000000000000000000000000000000000000
00000000000000000000000000000000000000000000000000000000000000000000000000000000000000000000000000000000000000000000000000000000
00000000000000000100000000000000000000000000000000000000000000000000000000000000000000000000000000000000000000000000000000000000
00000000000010000000000000000000000000000000000000000000000000000000000000000000000000000000000000000000000000000000000000000000
00000000000000000000000000000000000000000000000000000000000000000000000000000000000000000000000000000000000000000000000000000000
00000000000000000000000000000000000000000000000000000000000000000000000000000000000000000000000000000000000000000000000000000000
00000000000000000000000000000000000000000000000000000000000000000001111000000000000000000000000000000000000000000000000000000000
00000000100000000000000000000000000000000000000000000000000000000001000111111000000000000000000000000000000000000000000000000000
00000000000000010000000000000000000000000000000000000000000000011110000000000111000000000000000000000000000000000000000000000000
00000000000000000000000000000000000000000000000000000000000000010000000000111111000000000000000000000000000000000000000000000000
00000000000000000000000000000000000000000000000000000000000000010001111111000000000000000000000000000000000000000000000000000000
00000000000000000000000000000000000000000000000000000000000000011110000000000000000000000000000000000000000000000000000000000000

//
spawn
1494
20
11
11
100
10

2025
195
11
11
100
10

700
460
11
11
100
10

44
35
12
12
100
10

485
25
12
12
100
10

515
260
12
12
100
10

1039
181
10
10
100
10

45
430
10
10
100
10

705
795
10
10
100
10

1530
650
10
10
100
10

1900
560
10
10
100
10
new
//
caisses

1622
41

1402
250

820
25

638
300

275
65

560
530

1105
588

1756
556
//
barrels

1295
825
barrel

565
770
barrel

790
511
barrel

345
666
barrel

245
515
barrel

115
303
barrel

490
383
barrel

225
175
barrel

515
35
barrel

975
170
barrel

1275
61
barrel

1968
237
barrel

1690
166
barrel
//
arrivee
1890
385
//
bossentry
0
0
//
jetpacks

137
561

400
180

1467
147

726
657
//