scrolling
1
178
1580
physique
50
101
00000000000000000011000000101000000000000000000000
00000000000000000111000000101000000000000000000000
00000000001111111101000000101000000000000000000000
00000000001011000001011100101111111111110000000000
00000000001000000001110111100000000000010000000000
00000000001000000000100010000000000000010000000000
00000000001000000000000000000000000000010000000000
00000000001000000000000000000000000000010000000000
00000000001000000000000000000000000000010000000000
00000000001000000000000000000000000000010000000000
00000000001000000000000000000000000000010000000000
00000000001111111110000000000000000000010000000000
00000000001111111110000000000000000000010000000000
00000000000000000010000000000000000000010000000000
00000000000000000011100000000000000000011111000000
01111111111111111110100000000000000000000001000000
01000000000000000010100000000000000000000001000000
01000000000000000011100011110000000000000001000000
01011111111111100011000010010000000000001111000000
01010000000000100011000010010000000000011000000000
01010000000000100011000011110000000000010000000000
01010000000000100000000000000000000000111111000000
01010000000000100000000000000000000001111001000000
01010000000000100000000000000000000001100001000000
01010000000000100000000000000000011111100001000000
01010000000000100000000000000000010000100001000000
01010000000000100000000000000000010000100001000000
01010000000000100000000000000000010000100001000000
01010000000000100000000000000000010000100001000000
01010000000000100000000000000000010000100001000000
01010000000000100000000000000000010000100001000000
01010000000000100000000000000000010000101111000000
01010000000000100000000000000000010000101000000000
01010000000000100000000000000000010000101000000000
01010000000000111111000011111100010000101000000000
01010000000000010001000010001100010000101000000000
01010000000000011111000010001100010000101000000000
01010000000000000001000010001100010000101000000000
01010000000000000001000010000100010000101000000000
01010000000000000001000010000100010000101000000000
01010000000000000001000010000100010000101000000000
01010000000000000001000010000100010000101000000000
01010000000000111111000010000100010000101000000000
01011111111111100000000010000100011111101000000000
01000000000000000000000010000100000000001000000000
01000111100000000000000010000100001111111000000000
01000110100000000000000010000100001000000000000000
01000110100000000000000011111100001000000000000000
01000100100000000000000000000000001000000000000000
01000100100000000000000000000000001000011111111111
01111100100000000000000000000000001111110000000000
00000000100000000000000000000000000000000000000000
00000000100000000000000000000000000000000000000000
00000000100000000000000000000000000000000000000000
00000011100000000000000000000000000000000000000000
00000010000000000000000011111100001111111100000000
00000010011110000000000010011100001100000100001111
00000010011110000000000010001111111000000100001111
00000010000011111100000010000000000000000100001000
00000010000011111100000010000000000000000100001000
01111110000000111011111110000000000000000100001000
01001000000000111010000110000000000000000100001000
01111000000000111010111110000000000000000100001000
01111000000000111011100110000000000000000100001000
01000000000000000011111110000000000000000100001000
01000000000000000000000010011000000000000100001000
01000111111111111111000010011111100000000100001000
01000100000000000001000010010000100000000100001000
01000100000000000001000010010000111000000100001000
01000100000000000001000010010000001000000100001000
01000100000000000001000010010000001000000100001000
01000100000000000001000010010000001000000100001111
01000100000000000001000010010000001000000100000000
01100100000000000001000010010000001000000100000000
01100100000000000001000011110000001111111100000000
01000100000000000001000000000000000000000000000000
01000111111011111111000000000000000000000000000000
01000000001110000000000000000000000000000000000000
01000000000000000000000000000000000111111111111111
01000000000000000000000000000000000100000000000000
01000000000000000000000000000000000100000000000000
01000000000000000000000000000000000100000000000000
01100000000000000000000000000000000100000000000000
00100000000000000000000000000000000100000000000000
00100000000000000000000000000000011100000000000000
00100000000000000000000000000000010000000000000000
00100000000000000000000000000001110000000000000000
00100000000000000000000000000001000000000000000000
00111111111000000000000000000111000000000000000000
00100000001111000000000000000100000000000000000000
00100000000001000000000000000100000000000000000000
00100000000001000000000000000100000000000000000000
00100000000001000000000000011100000000000000000000
00100000000001100000000000010000000000000000000000
00100000000000100000000000010000000000000000000000
00111111111111111100000000010000000000000000000000
00000000001110011100000000010000000000000000000000
00111111111111110100000000010000000000000000000000
00100000011011000000000000010000000000000000000000
00100000000000000000000000010000000000000000000000

eau
00000000000001100111111111111111111111111111111111
00000000000001000111111111101111111111111111111111
00000000000111111101011111101111111111111111111111
00000000000011000001111111101111111111111111111111
00000000000000000000100010000000000000011111111111
00000000000000000000000000000000000000011111111111
00000000000000000000000000000000000000011111111111
00000000000000000000000000000000000000011111111111
00000000000000000000000000000000000000011111111111
00000000000000000000000000000000000000011111111111
10000000000000000000000000000000000000011111111111
10000000000000000000000000000000000000011111111111
00000000000000000000000000000000000000011011111111
00000000000000000000000000000000000000011111111111
00000000000000000000000000000000000000011111111111
00000000000000000000000000000000000000000001111111
00000000000000000000000000000000000000000001111111
00011111111111100000000000000000000000000001111111
00011111111111100000000000000000000000000001111111
00011111111111100000000000000000000000000111111111
00011111111111100000000000000000000000000111111111
00011111111111100000000000000000000000000001111111
00011111111111100000000000000000000000000001111111
00011111111111100000000000000000011111100001111111
00011111111111100000000000000000011111100001111111
00011111111111100000000000000000011111100001111111
00011111111111100000000000000000011111100001111111
00011111111111100000000000000000011111100001111111
00011111111111100000000000000000011111100001111111
00011111111111100000000000000000011111100001111111
00011111111111100000000000000000011111101111111111
00011111111111100000000000000000011111101000111111
00011111111111100000000000000000011111101000111111
00011111100111100000000011111100011111101111111111
00011111100111100000000001110100011111101111111111
00011111100001100000000011111100011111101111111111
00011111100001100000000011111100011111101111111111
00011111100000000000000011111100011111101111111111
00011111100000000000000011111100011111101111111111
00011111111111100000000011111100011111101111111111
00011111111111100000000011111100011111101111111111
00011111111111100000000011111100011111101111111111
00011111111111100000000011111100011111101111111111
00000000000000000000000011111100000000001111111111
00000000000000000000000011111100001111111111111111
00000000000000000000000011111100001111111111111111
00000000000000000000000011111100001111111111111111
00000000000000000000000000000000001111111111111111
00000000000000000000000000000000001111111111111111
00000000000000000000000000000000001111111111111111
00000000000000000000000000000000000000000000000000
00000000000000000000000000000000000000000000000000
00000000000000000000000000000000000000000000000000
00000000000000000000000000000000000000000000000000
00100000000000000000000011111100001111111100000000
01110000000000000000000011110100001111111100001111
01110000000000000000000011111111111111111100001111
00000000000000000000000011111111111111111100001111
00000000000000000000000011111111111111111100001111
00000000000000000000000011111111111111111100001111
00000000000000000000000011111111111111111100001111
00111000000000000000000011111111111111111100001111
00111000000000000000000011111111111111111100001111
00000000000000000000000011111111111111111100001111
00000000000000000000000011111111111111111100001111
00000111111111111111000011111111111111111100001111
00000111111111111111000011110000111111111100001111
00000111111111111111000011110000111111111100001111
00000111111111111111000011110000001111111100001111
00000111111111111111000011110000001111111100001111
00000111111111111111000011110000001111111100001111
00000111111111111111000011110000001111111100000000
00000111111111111111000011110000001111111100000000
00000111111111111111000011110000001111111100000000
00000111111111111111000000000000000000000000000000
00000111111111111111000000000000000000000000000000
00000000001110000000000000000000000000000000000000
00000000000000000000000000000000000111111111111111
00000000000000000000000000000000000111111111111111
00000000000000000000000000000000000111111111111111
00000000000000000000000000000000000111111111111111
00000000000000000000000000000000000111111111111111
00000000000000000000000000000000000111111111111111
00000000000000000000000000000000011111111111111111
00000000000000000000000000000000011111111111111111
00000000000000000000000000000001111111111111111111
00000000000000000000000000000001111111111111111111
00000000000000000000000000000111111111111111111111
00011111111000000000000000000111111111111111111111
00000001111111000000000000000111111111111111111111
00000000000001000000000000000111111111111111111111
00000000000001000000000000011111111111111111111111
00000000000001000000000000011111111111111111111111
00000000000001100000000000011111111111111111111111
00000000011111100000000000011111111111111111111111
00000000011111000000000000011111111111111111111111
00000000011111000100000000011111111111111111111111
00000000011111000000000000011111111111111111111111
00000000000000000000000000011111111111111111111111
00000000000000000000000000011111111111111111111111

//
spawn
220
1350
0
0
100
10
new

185
735
2
2
100
10
new

340
440
3
3
100
10
new

570
310
4
4
100
10
new
//
caisses

510
360

230
830

550
205

295
350

360
940

65
1360
//
barrels

65
1580
barrel

500
1320
barrel

240
1470
barrel

325
1320
barrel

225
1240
barrel

210
999
barrel

350
1060
barrel

495
1120
barrel

770
1200
barrel

765
830
barrel

433
785
barrel

50
780
barrel

255
520
barrel

600
275
barrel

600
100
barrel
//
arrivee
353
115
//
bossentry
0
0
//
jetpacks

474
161
//