PONEY
9
321
81
physique
50
31
00000000000000000000000000000000000000000000000000
00000000000000000000000000000000000000000000000000
00000000000000000000000000000000000000000000000000
00000000000000000000000000000000000000000000000000
00000001111111111111111111111111111111110000000000
00000010000000000001010000000000000000010000000000
00000010000000000000000000000000000000010000000000
00000010000000000000000000000000000000010000000000
00000010000000000000000000000000000000011000000000
00000110000000000000000000000000000000000100000000
00001000000000000000000000000000000000000110000000
00001000000000000000000000000000000000000001100000
00001000000000000000000000000000000000000000100000
00111000000000000000000000000000000000000000100000
01000000000000000000000000000000000000000000100000
01000000000000000000000000000000000000000000100000
01000000000000000000000000000000000000000000010000
01000000000000000000000000000000000000000000010000
01000000000000000000000000000000000000011111100000
01000000000000000000000000000000000000010000000000
01000000000000000000000000000000000001100000000000
01000000000000000000000000000000000001000000000000
01000000000000000000000000000000011110000000000000
10000000000000000000000000000000010000000000000000
10000000000000000000000000000111100000000000000000
10000000000000000000000000000100000000000000000000
10000000000001111000000011111000000000000000000000
10000000000001000111100010000000000000000000000000
10000011111110000000011010000000000000000000000000
01111100000000000000000100000000000000000000000000
00000000000000000000000000000000000000000000000000

eau
00000000000000000000000000000000000000000000000000
00000000000000000000000000000000000000000000000000
00000000000000000000000000000000000000000000000000
00000000000000000000000000000000000000000000000000
00000011111111111111111111111111111111110000000000
00000010000000000001010000000000000000010000000000
00000010000000000000000000000000000000010000000000
00000010000000000000000000000000000000011000000000
00001110000000000000000000000000000000000100000000
00001000000000000000000000000000000000000110000000
00001000000000000000000000000000000000000001000000
00001000000000000000000000000000000000000000100000
00111000000000000000000000000000000000000000100000
01000000000000000000000000000000000000000000100000
01000000000000000000000000000000000000000000111111
01000000000000000000000000000000000000000000000000
01000000000000000000000000000000000000000000000000
01000000000000000000000000000000000000000000000000
01000000000000000000000000000000000000000000000001
01000000000000000000000000000000000000000000000001
01000000000000000000000000000000000000000111111110
01000000000000000000000000000000000000000100000000
10000000000000000000000000000000000000011000000000
10000000000000000000000000000000000000010000000000
10000000000000000000000000000000000111100000000000
10000000000000000000000000000000000100000000000000
10000000000000000000000000000001111000000000000000
10000000000000000000000000000001000000000000000000
10000000000000000000000000000001000000000000000000
10000000000000000000000000000001000000000000000000
00000000000000000000000000000000000000000000000000

//
spawn
-2000
-2000
-100
-100
-50
-50
new
//
caisses

695
265

600
90

430
385
//
barrels

205
300
barrel

380
250
barrel
//
arrivee
0
0
//
bossentry
0
0
//
jetpacks

0
0
//