PONEY
3
700
330
physique
50
31
00000000000000000000000000000000000000000000000000
00000000000000000000000000000000000000000000000000
00000000000000000000111000000000000000001111000000
00000000000000000001101100000000000000001111110000
00000000000000000001000100000000000000011000010000
00000001111111111111000110000000000000010000010000
00000001000000000000000010000000000001110000010000
00011111000000000000000011100000000001000000010000
00010000000000000000000000111100000001000000010000
00010000001111001111000000001111000001000000100000
00010000111111001111000000000001000001110000100000
01111000111111001111000000000001111111111100111110
01000000000000000000000000000000000000000000000010
01000000000000000000000000000000000000000000000010
01000000000001110011000111000011110000000000000010
01111111110001110011000111000011110011111111111110
00000000110000110011000000000011110011111000000000
00000000100000110011000000000000000011101000000000
00000011100000000000000110000000000000001111110000
00000010000000000000000000000011100000000000010000
00000010000000000000000000000011000000000000010000
01111110000000111111000000000011000000000000010000
01000000000000101111000000000011000011100000010000
01000000000000101111000000000000000011111111110000
01000000111111101100000000000000000010000000000000
01110011100000001111000000000000000110000000000000
00010010100000000111000000000111111110000000000000
00011110100000000100000000000100000000000000000000
00000000000000000111111111111100000000000000000000
eau
11111111111111111111111111111111111111111111111111
11111111111111111111111111111111111111111111111111
11111111111111111111111111111111111111111111111111
11111111111111111111000111111111111111111000011111
11111111111111111111000011111111111111111000011111
11111111000000000000000011111111111111110000011111
11111111000000000000000001111111111111000001111111
11110000000000000000000000111111111111000000011111
11110000001111001111000000001111111111110000111111
11110000001111001111000000000001111111110000111111
11111000111111001111000000000001111111111100111111
11000000000000000000000000000000000000000000000011
11000000000000000000000000000000000000000000000011
11000000000000000000000000000000000000000000000011
11111111110000000000000000000000000011111111111111
11111111110000000000000000000000000011111111111111
11111110000000000000000000000000000011111111111111
11111110000000000000000000000000000000001111111111
11111111100000000000000000000000000000000000011111
11111110000000000000000000000000000000000000011111
11111110000000111111000000000000000000000000011111
11000000000000111111000000000000000111100000011111
11000000000000111111000000000000001111111111111111
11000000111111111111000000000000001011111111111111
11000000111111111100000000000000001111111111111111
11111011111111111111000000001111111111111111111111
11111111111111111100000000011111111111111111111111
11111111111111111111111111111111111111111111111111
11111111111111111111111111111111111111111111111111
11111111111111111111111111111111111111111111111111

//
spawn
430
200
5
5
100
10
new
//
caisses

695
75

42
200

42
365
//
barrels

445
285
barrel

320
415
barrel
//
arrivee
0
0
//
bossentry
0
0
//
jetpacks

0
0
//