PONEY
0
510
75
physique
50
31
00000011111101111110000000000000000000000000010001
00001111101000000001000000000000000000000000010001
00010000000000000110000000000000000000000000010001
00100000000000000100000000000001111000000000010001
01100000000000011000000000000010000100000000010001
10000000000000010000000000000010000100000000010001
10000000000000010000000000000010000100000000010001
01000000000000010000000000000001100100000000010001
01000000000000010000000000000000100100000000010001
01000000000000010000000000000010100100000000010001
00110000000000010000000000000101100110000000010001
00001100000000011111111111111100000001000000010001
11111111100000000000000000000000000001111000010001
00000000000000000000000000000000000000000100010001
00000000000000000000011100111110000000000110010001
00000000000000000000011100111110000000000001010000
00000000000001111100011100111110000000000001110000
00111110000001101100000000111110000001111000000000
00111110000001111100000000000010000001001000000011
00111110000001000000111100111000000110000110010011
00000000000000000000111100111000000100000010010001
00000000000000000000111100111000000100000001110001
00000000000000000000100000000000000100000000010001
00000000000000000000000000000000011000000000010001
00000111111111000000001000100000010000000000001110
11111000000000111111111000111111100000000000000000
00000000000000111111111000110000000000000000000000
00001110010011100000001000101000000000000000000000
00001001111100000000000000001000000000000000000000
00001100000000000000000000001000000000000000000000
00000000000000000000000000000000000000000000000000

eau
00000000111111111111000000000000000000000000010001
00000000101000000001000000000000000000000000010001
00000000000000000110000000000001111000000000010001
00000000000000000100000000000010000100000000010001
00000000000000011000000000000010000100000000010001
00000000000000010000000000000010000100000000010001
00000000000000010000000000000010000100000000010001
00000000000000010000000000000001100100000000010001
00000000000000010000000000000000100100000000010001
00000000000000010000000000000011100111000000010001
00000000000000011111111111111100000001000000010001
00000000000000000000000000000000000001111000010001
00000000000000000000000000000000000000000100010001
00000000000000000000000000000000000000000110010001
00000000000000000000000000111110000000000001010001
00000000000000000000000000111110000000000001110000
00000000000001111100000000111110000000000000010000
00111110000001111100000000000010000001111000000000
00111110000001000000000000000010000001001000000011
00000000000001000000111100000000000110000110010011
00000000000000000000111100000000000100000010010001
00000000000000000000100000000000000100000001110001
00000000000000000000100000000000000100000000010001
00000000000000000000000000000000011111111111110001
00000111111111000000001000100000000000000000011111
00000100000001000000001000100000000000000000000000
00000100000000100000001000100000000000000000000000
00001111111111100000001000100000001110000000000000
00001000000000000000000000000000001110000000000000
00000000000000000000000000000000000000000001000000
00000000000000000000000000000000000000000000000000

//
spawn
100
100
0
0
100
10

150
100
0
1
100
10

550
240
1
1
100
10
new
//
caisses

250
30

635
210

500
250
//
barrels

115
303
barrel

490
383
barrel

225
175
barrel
//
arrivee
0
0
//
bossentry
0
0
//
jetpacks

0
0
//