PONEY
15
340
60
physique
50
31
00000000000000000000000000000000000000000000000000
00000000000000000000000000000000000000000000000000
00001111111101111111111111011111111111111100000000
00001000000000000000000000000000000000000010000000
00001000000000000000000000000000000000000011110000
00001000000000000000000000000000000000000000001000
00001000000000000000000000000000000000000000001000
00001000000000000000000000000000000000000000001000
00001000000000000000000000000000000000000000001000
00001000000000000000000000000000000000000000001000
00000100000000000000000000000000000000000000001000
00000100000000000000000000000000000000000000001000
00000011000000000000000000000000000000000000001000
00000001000000000000000000000000000000000000111000
00000000100000000000000000000000000000000000100000
00000000100000000000000000000000000000000000100000
00000000010000000000000000000000000000000111000000
00000000010000000000000000000000000000000100000000
00000000010000000000000000000000000001111000000000
00000000010000000000000000000000000001000000000000
00000000010000000000000000000000000010000000000000
00000000010000000000000000000000000010000000000000
00000000010000000000000000000000000010000000000000
00000000010000000000000000000000001100000000000000
00000000010000000000000000000000010000000000000000
00000000001000000000000000000000010000000000000000
00000000000111100001100011000000100000000000000000
00000000000000100001100011000000100000000000000000
00000000000000011110011100111111000000000000000000
00000000000000000000000000000000000000000000000000
00000000000000000000000000000000000000000000000000

eau
00000000000000000000000000000000000000000000000000
00000000000000000000000000000000000000000000000000
00001111111111111111111111111111111111111100000000
00001000000000000000000000000000000000000011110000
00001000000000000000000000000000000000000000001000
00001000000000000000000000000000000000000000001000
00001000000000000000000000000000000000000000001000
00011000000000000000000000000000000000000000001000
00100000000000000000000000000000000000000000001000
00100000000000000000000000000000000000000000001000
00100000000000000000000000000000000000000000001000
00100000000000000000000000000000000000000000001000
00100000000000000000000000000000000000000000001000
00100000000000000000000000000000000000000000110000
00100000000000000000000000000000000000000000100000
00100000000000000000000000000000000000000000100000
00011110000000000000000000000000000000000000100000
00000010000000000000000000000000000000000000100000
00000010000000000000000000000000000000000000100000
00000010000000000000000000000000000000000000100000
00000010000000000000000000000000000000000000100000
00000001110000000000000000000000000000000000100000
00000000010000000000000000000000000000111111000000
00000000010000000000000000000000000000100000000000
00000000010000000000000000000000000000100000000000
00000000010000000000000000000000000000100000000000
00000000001111100001100011000000111111000000000000
00000000000000100001100011000000100000000000000000
00000000000000011110011100111110000000000000000000
00000000000000000000000000000000000000000000000000
00000000000000000000000000000000000000000000000000

//
spawn
-2000
-2000
-100
-100
-50
-50
new
//
caisses

95
62

633
270

353
430

180
380

640
60
//
barrels

272
225
barrel

467
225
barrel
//
arrivee
0
0
//
bossentry
0
0
//
jetpacks

0
0
//