scrolling
12
35
70
physique
90
61
000010000010000000000000001010000000000000000000010000001110000000001000000000000000000000
000010000010000000000000010010000000000000000000010000001110000000001111111111111111111111
000010000011100000000000010010000000000000000000010000001010000000000000000000000000000000
111110000000010000000001100010000000000000000000010000000000000000000000000000000000000000
000000000000010000000010000010000000000000000000010000000000000000000000000000000000000000
000000000000010000001100000010000000000000000000010000000000000000000000000000000000000000
000000000001100000010000000010000000000000000000011111110011111111111111111111000000000000
000000000001000000100000000010000000000000000000000000000000000011111000111111000000000000
000000000001000000100000000010000000000000000000000000000000000011111000111111000000000000
000000000001000000100000000011111111111000000000000000000000000011111000111111000000011111
000000000110000000100000000000011111001000000000000000000000000000000000000001000000010000
000000000100000001000000000000011111001000000000000000000000000000000000000001000000010000
000000011000000001000000000000011111001000000000000000000000000000000000000001000000010000
000000010000000010000000000000000000001000000000000000000000000000000000000001000000011111
010001010000000011100000000000000000001000000000000000000000000000000000000001000000000000
110001100000000000100000000000000000001000000000000000000000000000000000000001000000000000
110001000000000000100000000000000000001000000000000000000000000000000000000001000000000000
010001000000000000100000000000000000001000000000000000000000000000000000000001111111111111
000000100000000000100000000000000000001000000000000000000000000000000000000000000000000000
000000100000000000100000000000000000001001111100000000000000000000000000000000000000000000
000000111111100000100000000000000000001111111111110000000000000000000000000000000000000000
000000000000010000011000000000000000000001111100010000000000000000000000000000000000000000
000000000000010000001000000000000000000001111100010000000000000000000000000000000000000000
000000000000010000001000000000000000000000000000011111110000000000000000000000000000000000
000000000000010000001000000000000000000000000000000000010000000001111111111111111111100000
000000000000010000000110000000000000000000000000000000010000000001000000000000000000100000
000000000000011000000011111111100000000000000000000000010000000001000000000000000000100000
000000000000000100000100011111100000000000000000000000010000000001000000000000000000100000
000000000000000110000100011111100000000000000000000000010000000001000000000000000000100000
000000000000000001000100011111111110011111000000000000011111000001000000000000000000100000
000000000000000001000100000000000000000001000000000000000001000001000000000000000000100000
000000000000000001100011100000000000000001000000000000000001000001000000000000000000100000
000000000000000000010000100000000000000001000000000000000001000001111111111111111111100000
111000000000000000010000100000000000000001000000000000000001000000000000000000000000000000
001000000000000000010000100000000000000001000000000000000001000000000000000000000000000000
001000000000000000011000011000000000000001000000000000000001000000000000000000000000000000
001000000000000000000100001000000000000001000000000000000001111100000000000000000000000000
001000000000000000000100001000000000000001000000000000000000000100000000000000000000000000
001000000000000000000100001000000000000001000000000000000000000100000000000000000000000000
000111110000000000000111000111000000000001000000000000000000000111111111111111111001111111
000000010000000000000000100001000000000001000000000000000000000000111110000000000000000000
000000010000000000000000100001000000000001000000000000000000000000111110000000000000000000
000000010000000000000000100001000000000001000000000000000000000000111110000000000000000000
000000010000000000000000100001000000000001000000000000000000000000000000000000000000000000
000000010000000000000000111000111100000001000000000000000000000000000000000000000000000000
000000010000000000000000000100000100000001111111111100000000000000000000000000000000000000
000000010000000000000000000100000011000001000000000100000000000000000000000000000000000000
000000010000000000000000000100000001100010000000000100000000000000000000000000000000000000
000000010000000000000000000111111000100010000000000100000000000000000000000000000000000000
000000010000000000000000000000001111100010000000000011110000000000000000000000000000000000
000000001111100000000000000000000000100011000000000000001111000000000000000000000000000111
000000000000100000000000000000000000000001000010000000000000111000000000000000000000000100
000000000000100000000000000000000000000001000101000000000000001000000000000000000000000100
000000000000100000000000000000000000000001111101000000000000001000000000000000111111111000
000000000000011111111100000000000000000000000001000000000000001000000000000000100000000000
000000000000000000000100000000000000000000000001000000000000001000000000000000100000000000
000000000000000000000100000000000000000000000001110000000000001000000000000000100000000000
000000000000000000000100000000000000000000000000001000000000001000000000111111000000000000
000000000000000000000011111111111111000000000000001000000000001000000000100000000000000000
000000000000000000000000000000000001000000000000001000000000001000000000100000000000000000

eau
111110000011110000000000001010000000000000000000010000001110000000001111111111111111111111
111110000011110000000000010010000000000000000000010000001110000000000000000000000000000000
111110000000000000000000010010000000000000000000010000001010000000000000000000000000000000
000000000000000000000001100010000000000000000000010000000000000000000000000000000000000000
000000000000000000000010000010000000000000000000010000000000000000000000000000000000000000
000000000000000000001100000010000000000000000000010000000000000000000000000000000000000000
000000000000000000010000000010000000000000000000011111110011111111111111111111000000000000
000000000000000000100000000010000000000000000000000000000000000011111000111111000000000000
000000000000000000100000000010000000000000000000000000000000000011111000111111000000000000
000000000000000000100000000011111111111000000000000000000000000000000000000001000000011111
000000000000000000100000000000011111001000000000000000000000000000000000000001000000010000
000000000000000001000000000000011111001000000000000000000000000000000000000001000000010000
000000000000000001000000000000000000001000000000000000000000000000000000000001000000011111
000000000000000010000000000000000000001000000000000000000000000000000000000001000000000000
010001000000000001100000000000000000001000000000000000000000000000000000000001000000000000
010001000000000000100000000000000000001000000000000000000000000000000000000001000000000000
010001000000000000100000000000000000001000000000000000000000000000000000000001000000000000
010001111111100000100000000000000000001000000000000000000000000000000000000001111111111111
000000111111100000100000000000000000001000000000000000000000000000000000000000000000000000
000000111111100000100000000000000000001001111100000000000000000000000000000000000000000000
000000000000000000100000000000000000001111111111110000000000000000000000000000000000000000
000000000000000000011000000000000000000001111100010000000000000000000000000000000000000000
000000000000011000001000000000000000000000000000010000000000000000000000000000000000000000
000000000000011000001000000000000000000000000000011111110000000000000000000000000000000000
000000000000011000001000000000000000000000000000000000010000000001111111111111111111100000
000000000000011000001110000000000000000000000000000000010000000001000000000000000000100000
000000000000000110000011111111100000000000000000000000010000000001000000000000000000100000
000000000000000110000000011111100000000000000000000000010000000001000000000000000000100000
000000000000000000000000011111100000000000000000000000010000000001000000000000000000100000
000000000000000000000000000000111110011111000000000000011111000001000000000000000000100000
000000000000000000000000000000000000000001000000000000000001000001000000000000000000100000
000000000000000000000000000000000000000001000000000000000001000001111111111111111111100000
000000000000000000000000000000000000000001000000000000000001000000000000000000000000000000
111000000000000000000000000000000000000001000000000000000001000000000000000000000000000000
001000000000000000000000000000000000000001000000000000000001000000000000000000000000000000
001000000000000000000000000000000000000001000000000000000001000000000000000000000000000000
001000000000000000000000000000000000000001000000000000000001111100000000000000000000000000
001000000000000000000000000000000000000001000000000000000000000100000000000000000000000000
001000000000000000000000000000000000000001000000000000000000000100000000000000000000000000
000111110000000000000000000000000000000001000000000000000000000111111111111111111001111111
000000010000000000000000000000000000000001000000000000000000000000111110000000000000000000
000000010000000000000000000000000000000001000000000000000000000000111110000000000000000000
000000010000000000000000000000000000000001000000000000000000000000000000000000000000000000
000000010000000000000000000000000000000001000000000000000000000000000000000000000000000000
000000010000000000000000000000000000000001000000000000000000000000000000000000000000000000
000000010000000000000000000000000000000001111111111100000000000000000000000000000000000000
000000010000000000000000000000000000000000000000000100000000000000000000000000000000000000
000000010000000000000000000000000000100010000000000100000000000000000000000000000000000000
000000010000000000000000000000000000100010000000000100000000000000000000000000000000000000
000000010000000000000000000000000000100011111100000111110000000000000000000000000000000000
000000001111100000000000000000000000100011111100000000011111000000000000000000000000000111
000000000000100000000000000000000000000001111100000000000001111000000000000000000000000100
000000000000100000000000000000000000000001111100000000000000001000000000000000000000000100
000000000000100000000000000000000000000000000000000000000000001000000000000000111111111000
000000000000011111111100000000000000000000000000000000000000001000000000000000100000000000
000000000000000000000100000000000000000000000000000000000000001000000000000000100000000000
000000000000000000000100000000000000000000000000000000000000001000000000000000100000000000
000000000000000000000100000000000000000000000000000000000000001000000000111111000000000000
000000000000000000000011111111111111000000000000000000000000001000000000100000000000000000
000000000000000000000000000000000001000000000000000000000000001000000000100000000000000000

//
spawn
130
385
0
0
100
10

130
535
0
0
100
10

255
715
0
0
100
10

550
600
0
0
100
10

530
350
14
14
100
10

765
475
14
14
100
10

875
642
14
14
100
10

1085
888
14
14
100
10

1366
720
14
14
100
10

975
336
14
14
100
10

1105
266
14
14
100
10

810
165
14
14
100
10
new
//
caisses

245
480

144
777

488
795

720
877

415
530

633
495

395
235

695
686

1090
710

1393
460

1117
138

1130
305
//
barrels

105
455
barrel

235
633
barrel

200
713
barrel

372
900
barrel

500
672
barrel

485
500
barrel

910
520
barrel

1230
825
barrel

800
250
barrel
//
arrivee
915
50
//
bossentry
0
0
//
jetpacks

1190
768

960
263
//