scrolling
14
100
575
physique
90
61
000000000000000000000000000000000000000000000000000000000000000000000000000000000000000000
000000000000000000000000000000000000000000000000000000000000000000000000000000000000000000
000000000000000000000000000000000000000000000000000000000000000000000000000000000000000000
000000000000000000000000000000000000000000000000000000000000000000000000000000000000000000
000000000001111111111111111111111111100110000000000000000000000000000000000000000011111100
000000000010000000000000000000000000011001000000000000000000000000000011111111111100000010
000000000010000000000000000000000000011001000000000000000000000000000100000000000000000010
000000111110011111111111111000000000000001111110000000000000000000000100000000000000000010
000001000000010000000000001000000000000000000001000000000011111111011100111111000000000010
000001000000010000000000001000000000000000000001000000000100000000100000111110100000000010
000001000000010000000000001000000000000000000001111111111100000000000000000010100000000010
000001000000010000000000001000000000000000000000000000000000000000000000000010010000000010
000001000000010000000000000111111100000000000000000000000000000000000000000010010000000010
000001000000010000000000000000000011111110000110000000000000000000001111000010001100000010
000001000000010000000000000000000000000001110110000000000000000000001001000100011100000010
000001000000011100000000000000000000000000001001100000000000000000001001000100100000000010
000001000000000010000000000000000000000000000000011100000000000000001000111001100000000010
000001000000000011110000000000000000000000000000000010000000110000001100000010000000000010
000001000000000000001000000000000000000000000000000001111000110000000010000001111100000010
000001000000000000001000000000000000000000000000000000001000000000000010000000000100000010
000001000000000000001000000000000000000000000000000000000100000000000011111000000011000010
000001000000000000000111000000000000000000000000000000000010000000000000000100000001000010
000000111100000000000000100000000000000000000000000000000001000000000000000111100001000010
000000000100000000000000100000000000000000000000000000000000100000000000000000011111000010
000000000100000000000000100000000000000000000000000000000000011000000000000000000000110010
000000000100011100000000100000000000000000000000000000000000001000000000000000000011101100
000000000100011100000000100000000000000000000000000000000000001000000000000000000011000000
000000000100011100000000100000000000000000000000000000000000010000000000000000000000100000
000000000100000000000000010000000000000000000000000000000000100000000000000000000000100000
000000000100000000000000001000000000000000000000000000000000100000000000000000000000100000
000000000100000000011100001000000000000000000000000000000000100000000000000000000000100000
000000000100000000011100001000000000000000000000000000000001000000000000000000000000100000
000000000100000000011100001000000000000000000000000000000001000000000000000000000000100000
000000000100000000000000000100000000000000000000000000000001000000000000000000000000100000
001111111100000000000000000010000000000000000000000000000001000000000000000000000000100000
010000000000000000000000000001100000000000000000000000000000100000000000000000000000100000
010000000000000000000000000000011000000000000000000000000000100000000000000000000000100000
000000000000000000000000000000000100000000000000000000000001100000000001111110000000100000
010000000000000000000000000000000100000000000000000000000010000000011110000010000000100000
010000000111111111110000000000000100000000000000000000000010000000010000000010000000100000
010000000100000000010000000000000011100000000000000000000110000111100000000010000000100000
010000000100000000010000000000000000010000000000000000001000000100000000000010000000100000
010000000100000000010000000000000000001000000000000000010000000100000000000010000000100000
010000000100000000010000000000000000001000000000000000010000000100000000011110000000100000
010000000100000000010000000000000000001111110000001110001111111100000000100000000000100000
001111000100000000110000000000000000000000001111110001000000000000000000100000000000100000
000111000111111111100000000000000000000000000000000001000000000000000000100000001111000000
000100000000000000000000000000000000000000000000000001000000000000011111000000001000000000
000100000000000000000000000000000000000000000000000001000000000000100000000000001000000000
000100000000000000000111111111000000000000000000000001000000111100100000000000001000000000
000100000000000000000100000001000000000000000000000001000001000011100000000000001000000000
000100000000000000000100000001000000000000000000000001000001000000000000000000001000000000
000100000000000000000100000001000000000000000000000001000001000000000000000000001000000000
000100000000000000000100000000111100000000000000000001111111000000000000000000001000000000
000100000000000000000011000000000100000000000000000000000000000000000000000000001000000000
000011110000000000000000111000000100000000000000000000000000000000000000000000001000000000
000000010000000000000000000100000100000000000000000000000000000000000000000000001000000000
000000001111111111111111111000000011111111111111111111111111111111111111111111110000000000
000000000000000000000000000000000000000000000000000000000000000000000000000000000000000000
000000000000000000000000000000000000000000000000000000000000000000000000000000000000000000

eau
000000000000000000000000000000000000000000000000000000000000000000000000000000000000000000
000000000000000000000000000000000000000000000000000000000000000000000000000000000000000000
000000000000000000000000000000000000000000000000000000000000000000000000000000000000000000
000000000000000000000000000000000000000000000000000000000000000000000000000000000000000000
000000000001111111111111111111111111100111000000000000000000000000000011111111111111111110
000000000010000000000000000000000000011001000000000000000000000000000100000000000000000010
000000111110000000000000000000000000000001111110000000000000000000000100000000000000000010
000001000000011111111111111000000000000000000001000000000000000000011100000000000000000010
000001000000010000000000001000000000000000000001000000000011111111100000000000000000000010
000001000000010000000000001000000000000000000001111111111100000000000000000000000000000010
000001000000010000000000001000000000000000000000000000000000000000000000000000000000000010
000001000000010000000000010000000000000000000000000000000000000000000000000000000000000010
000001000000010000000000010000000000000000000000000000000000000000000000000000000000000010
000001000000010000000000110000000000000000000110000000000000000000000000000000000000000010
000001000000011111110001000000000000000000000000000000000000000000000000110000000000000010
000001000000000000001001000000000000000000000000000000000000000000000000110000000000000010
000001000000000011110001000000000000000000000000000000000000000000000000000000000000000010
000001000000000011110001000000000000000000000000000000000000110000000000000000000000000010
000001000000000000001001000000001111111111111111000000000000000000000000000000000000000010
000001000000000000001101000000001000000000000001000000000000000000000000000000000000000010
000001000000000000000011000000001000000000000001000000000000000000000000000000000000000010
000001000000000000000000000000001000000000000001000000000000000000000000000000000000000010
000000111100000000000000000000001000000000000000111111100000000000000000000000000000000010
000000000100000000000000000000001000000000000000000000100000000000000000000000000000000010
000000000100000000000000000000001000000000000000000000100000000000000000000000000000110010
000000000100011100000000000000001111000000000000000000100000000000000000000000000011001100
000000000100011100000000000000000000100000000000000000011110000000000000000000000000001000
000000000100000000000000000000000000100000000000000000000010000000000000000000000000110000
000000000100000000000000000000000000100000000000000000011110000000000000000000000000100000
000000000100000000000000000000000000100000000000000000100000000000000000000000000000100000
000000000100000000011100000000000000100000000000000000100000000000000000000000000000100000
000000000100000000011100000000000000100000000000000000100000000000000000000000000000100000
000000000100000000000000000000000000100000000000000000100000000000000000000000000000100000
001111111100000000000000000000000000111100000000000000100000000000000000000000000000100000
010000000000000000000000000000000000000010000010000000010000000000000000000000000000100000
010000000000000000000000000000000000000010000101000000010000000000000000000000000000100000
010000000000000000000000000000000000000010000101000000010000000000000000000000000000100000
010000000000000000000000000000000000000010000101000000010000000000000001111110000000100000
010000000000000000000000000000000000000011111001111111110000000000011110000010000000100000
010000000111111111110000000000000000000000000000000000000000000000010000000010000000100000
010000000100000000010000000000000000000000000000000000000000000111100000000010000000100000
010000000100000000010000000000000000000000000000000000000000000100000000000010000000100000
010000000100000000010000000000000000000000000000000000000000000100000000011110000000100000
010000000100000000010000000000000000000000000000000000000000000100000000100000000000100000
010000000100000000110000000000000000000000000000000000111111111000000000100000000000100000
001111000111111111000000000000000000000000000000000001000000000000000001100000000000100000
000100000000000000000000000000000000000000000000000001000000000000011110000000001111100000
000100000000000000000000000000000000000000000000000001000000000000100000000000001000000000
000100000000000000000000000000000000000000000000000001000000000000100000000000001000000000
000100000000000000000111111111000000000000000000000001000001111111100000000000001000000000
000100000000000000000100000001000000000000000000000001000001000000000000000000001000000000
000100000000000000000100000001000000000000000000000001000001000000000000000000001000000000
000100000000000000000100000001000000000000000000000001111111000000000000000000001000000000
000100000000000000000100000000111100000000000000000000000000000000000000000000001000000000
000100000000000000000011111000000100000000000000000000000000000000000000000000001000000000
000011110000000000000000000100000100000000000000000000000000000000000000000000001000000000
000000010000000000000000000100000100000000000000000000000000000000000000000000001000000000
000000001111111111111111111000000011111111111111111111111111111111111111111111110000000000
000000000000000000000000000000000000000000000000000000000000000000000000000000000000000000
000000000000000000000000000000000000000000000000000000000000000000000000000000000000000000

//
spawn
205
825
13
13
100
10

440
660
13
13
100
10

685
820
13
13
100
10

320
410
13
13
100
10

160
260
13
13
100
10

1170
855
13
13
100
10

1285
480
13
13
100
10

1000
205
13
13
100
10

985
525
13
13
100
10
new
//
caisses

335
690

85
855

500
820

220
460

295
305

11
145

970
320

975
820

1170
180
//
barrels

323
538
barrel

223
265
barrel

675
733
barrel

450
165
barrel

1110
788
barrel

1200
388
barrel

890
265
barrel

1025
400
barrel
//
arrivee
0
0
//
bossentry
1345
95
//
jetpacks

1135
466
//