scrolling
10
10
175
physique
80
81
00000000000000000000000000000000000000000000000000000000000000000000000000000000
00000100000000000000000000000000000000000000000000000000000000000000000000000000
00001011000000000000000000000000000000000000000000000000000000000000000000000000
11111000100000000000000000000000000000000000000000111000000000000000000000000000
00000000110000000000000000000000000000000000000000100100000000000000000000000000
00000000001000000000000000000000000000000000000000101000000000000000000000000000
00000000001111111000000000000000000000000000000000101000000000000000000000000000
00000000000000000100000000000000000000000000000000100100000000000000000000000000
00000000000000000100000000000000000000000000000001100111111110000000001111111000
00000000000000000100000000000000000000000000000010000000000001000000010000000100
00000000000000000100000000000000000000000000001110000000000001000000010000000100
00000000000000000100000000000000000000000000010000000000000001100000010000000100
00000000000000000100000000000000000000000000010000000000000001111111110000000100
00000000000000000100000000000000000000000011110000000000000000000000000000000111
00000000000000000100000000000000000000111100000000000000000000000000000000000000
11111000000000000110000000000000000111000000000000000000000000000000000000000000
00001000000000000001000000000000001000000000000000000000000000000000000000000000
00001000000000000001000000000000000111110000000000000000000000000000000000000000
00001000000000000001000000000000000000010000000000000000000000000000000000000000
00001000000000000001100000000000000000010000000000000000000000000000000000000000
00001000000000000000010000000000000000010000000000000000000000000000000000000000
00001000000000000000010000000000000000001111111000000000000000000000000000000000
00001000000000000000010000000000000000000000001000000000000000000000000000000000
00001000000000000000010000000000000000000000001000000000000000000000000000000000
11111000000000000000011100000000000000000000001000000000000000000000000000000000
00000000000000000000000100000000000000000000001000000000000000000000000000000000
00000000000000000000000110000000000000000000001000000000000000000000000000000000
00000000000000000000000001000000000000000000000111111100000000000000000000000000
00000000000000000000000110000000000000000000000001111100000000000000000000000000
00000000000000000000000100000000000000000000000010000000000000000000000000000000
11111111100000000000000100000000000000000000000010000000000000000000000000000000
00000000100000000000000100000000000000000000000010000000000000000000000000000000
00000000100000000000000100000000000000000000000100000000000000000000000000000000
00000000100000000000111100000000000000000000001000000000000000000000000000000000
00000000100000000001000000000000000000000000011000000000000000000000000000000000
00000000100000000010000000000000000000000000100000000000000000000000000000000000
00000000100000000010000000000000000000000000100000000000000000000000000000000000
00000000100000000100000000000000000000000000011111111111111111111000000000000000
00000000100000000100000000000000000000000000000001001110000000001000000000000000
00000000100000000100000000000000000000000000000001001110000000001000000000000000
00000000100000000100000000000000000000000000011111001110000000001000000000000000
00000011100000000100000000000000000000000000100000000000000000001000000000000000
00000100000000000111111111111110000000000000100000000000000000001000000000000000
11111100000000000000000000000001000000000000100000000000000000001000000000000000
00000000000000000000000000000001000000000000100000000000000000001000000000000000
00000000000000000000000000000001000000000000100000000000000000001000000000000000
00000000000000000000000000000001000000000000100000000000000000001000000000000000
00000000000000000000000000000001000000000000100000000000000000001000000000000000
00000000000000000011111111110001000000000000100000000000000000001000000000000000
00000000000000000010000000010001000000000000100000000000000000001000000000000000
00000000000000000010000000010001000000000000100000000000000000001000000000000000
00000000000000000010000000010001000000000000100000000000000000001000000000000000
00000000000000000010000000010001000000000000100000000000000000001000000000000000
00000000000000000010000000101101000000000000100000000000000000001000000000000000
00000000000000111100000001010010000000000000100000000000000000001000000000000000
00000001111111000001111111010010000000000000100000000000000000001000000000000000
00000001000000000010000000010011100000000001100000000000000000000000000000000000
00000001000000000010000001101100010000000010000000000000000000000000000000000000
00000001000000111110000010010000011110000110000000000000000000000000000000000000
00000001000000100000000010010000000001001000000000000000000000000000000000000000
00100010000000100000000010010000000001111000000000000000000000000000000000000000
11100010000000010001000010010000000000000000000000000000000000000000000000000000
01100011000000010001110010010000000000000000000000000000000000000000000000000000
10100010100111110001001100110000000000000000000000000000000000000000000000000000
10000000100100010001100001000000000000011111100000000000000000000000000000000000
10000000111100000000010010000000000111100000101000100000000000000000000000000000
10000000000000000000010010000111111000000000011000111111111111111111111110000000
00000000000000000000010010000100000000010000011000111000000000000000000001000000
00000000000000000000001001111000000111101000101000100111111110000000000001000000
00000000000000000000001100001111111000001111100000000000000001000000000001000000
00000000000000000000000011110000000000000000000000000000000001111100000000111100
00000000000000000000000000000000000000000000000000000000000000000010000000000010
00000000000000000000000000000000000000000000000000000000000000000011110000000010
00000000000000000000000000000000000000000000000000000000000000000000001000000010
00000000000000000000000000000000000000000000000000000000000000000000001100000001
00000000000000000000000000000000000000000000000000000000000000000000000010000000
00000000000000000000000000000000000000000000000000000000000000000000000010000000
00000000000000000000000000000000000000000000000000000000000000000000000000000000
00000000000000000000000000000000000000000000000000000000000000000000000000000000
00000000000000000000000000000000000000000000000000000000000000000000000000000000

eau
00001000000000000000000000000000000000000000000000000000000000000000000000000000
00001000000000000000000000000000000000000000000000000000000000000000000000000000
11111000000000000000000000000000000000000000000000000000000000000000000000000000
00000001001111100000000000000000000000010000000000001000000000000000000000000000
00000000001111100000000000000000000000010000000000000000000000000000000000000000
00000000001111100000000000000000001000000000000000001000000000000000000000000000
00000000000000000000000000000011100000000000000000000100000000000000000000000000
00000000000000000110000000000000000000000000000000000111111110000000000000000000
00000000000000000110000000000000000000000000000000000000000001000000000000000000
00000000000000000110000000000000000000000000000000000000000001000000010000000000
00000000000000000110000000000000000000000000000000000000000001000000010000000000
00000000000000000110000000000000000000000000000000000000000001111111110000000000
00000000000000000110000000000000011111100000000000000000000000000000000000000000
00000000000000000111100000000000011111100000000000000000000000000000000000000000
00000000000000000111100000000000011111100000000000000000000000000000000000000000
11111000000000000001100000000000000000000000000000000000000000000000000000000000
00001000000000000001100000011000000000000000000000000000000000000000000000000000
00001000000000000001100000011000000000000000000000000000000000000000000000000000
00001000000000000001111000000000000000000000000000000000000000000000000000000000
00001000000000000000011000000000000000000000000000000000000000000000000000000000
00001000000000000000011110000000000000000000000000000000000000000000000000000000
00001000000000000000011110000000001111000000000000000000000000000000000000000000
00001000000000000000011110000000001111000000000000000000000000000000000000000000
11111000000000000000011110000000000000000000000000000000000000000000000000000000
00000000000000000000000110000000000000000000000000000000000000000000000000000000
00000000000000000000000110000000000000000000000000000000000000000000000000000000
00000000000000000000000001000000000000000000000000000000000000000000000000000000
00000000000000000000000000000000000000011110000000000000000000000000000000000000
00000000000000000000000000000000000000011111111110000000000000000000000000000000
00000000000000000000000000000000000000000001000010000000000000000000000000000000
11111111100000000000000000110000000000000001000010000000000000000000000000000000
00000000100000000000000000110000000000000001000110000000000000000000000000000000
00000000100000000000000000000000000000000001001000000000000000000000000000000000
00000000100000000000000000000000000000000001011000000000000000000000000000000000
00000000100000000000000000000000000000000001100000000000000000000000000000000000
00000000100000000000000000000000000000000001100000000000000000000000000000000000
00000000100000000000000000000000000000000001100000000000000000000000000000000000
00000000100000000000000000000000000000000001111111111111111111111000000000000000
00000000100000000001111110000000000000000000000001001110000000001000000000000000
00000000100000000001000000000000000000000000111111001110000000001000000000000000
00000011100000000001000000000000000000000000100000000000000000001000000000000000
00000100000000000001111111111110000000000000100000000000000000001000000000000000
11111100000000000000000000000001000000000000100000000000000000001000000000000000
00000000000000000000000000000001000000000000100000000000000000001000000000000000
00000000000000000000000000000001000000000000100000000000000000001000000000000000
00000000000000000000000000000001000000000000100000000000000000001000000000000000
00000000000000000000000000000001000000000000100000000000000000001000000000000000
00000000000000000000000000000001000000000000100000000000000000001000000000000000
00000000000000000000000000000001000000000000100000000000000000001000000000000000
00000000000000000000000000000001000000000000100000000000000000001000000000000000
00000000000000000000000000000001000000000000100000000000000000001000000000000000
00000000000000000000000000000001000000000000100000000000000000001000000000000000
00000000000000000000011111000001000000100000100000000000000000001000000000000000
00000000000000000000011111000001000000000000100000000000000000001000000000000000
00000000000000000000011110000001000000000000100000000000000000001000000000000000
00000000000000011110000000000001100000000001100000000000000000001000000000000000
00000000000000011110000000000000010000000010000000000000000000000000000000000000
00000000000000011110000000000000011110000110000000000000000000000000000000000000
00000000000000000000000000000000000001001000000000000000000000000000000000000000
00000000000000000000000000000000000001111000000000000000000000000000000000000000
00100010000000000000000000000000000000000000000000000000000000000000000000000000
00100010000000010001000000000000000000000000000000000000000000000000000000000000
00100010111100010001000000000000000000000000000000000000000000000000000000000000
00100010111100010001000000000000000000000000000000000000000000000000000000000000
00000000111100010001000000000000000000000000000000000000000000000000000000000000
00000000000000000000000000000000000000000000001000100000000000000000000000000000
00000000000000000000000000000000000000001111101000100000000000000000000000000000
00000000000000000000000000000000000000001111101000100000000000000000000000000000
00000000000000000000000000000000000000001111101000100000000000000000000000000000
00000000000000000000000000000000000000000000000000000000000000000000000000000000
00000000000000000000000000000000000000000000000000000000000000000000000000000000
00000000000000000000000000000000000000000000000000000000000000000000000000000000
00000000000000000000000000000000000000000000000000000000000000000000000000000000
00000000000000000000000000000000000000000000000000000000000000000000000000000000
00000000000000000000000000000000000000000000000000000000000000000000000000000000
00000000000000000000000000000000000000000000000000000000000000000000000000000000
00000000000000000000000000000000000000000000000000000000000000000000000000000000
00000000000000000000000000000000000000000000000000000000000000000000000000000000
00000000000000000000000000000000000000000000000000000000000000000000000000000000
00000000000000000000000000000000000000000000000000000000000000000000000000000000

//
spawn
165
280
0
0
100
10

275
400
1
1
100
10

300
724
2
2
100
10

30
1230
3
3
100
10

400
1230
4
4
100
10

930
1150
5
5
100
10

1025
965
0
0
100
10

820
795
1
1
100
10

1170
600
2
2
100
10

1130
322
3
3
100
10

825
215
4
4
100
10
new
//
caisses

276
269

105
680

333
945

575
1115

1222
975

740
570

770
405

1040
225
//
barrels

240
220
barrel

25
435
barrel

25
765
barrel

215
1050
barrel

500
980
barrel

997
1197
barrel

933
717
barrel

750
235
barrel

1175
185
barrel
//
arrivee
0
0
//
bossentry
915
155
//
jetpacks

212
440

180
1190

880
920

1030
375
//