scrolling
13
290
105
physique
80
81
00000000000000000000000000000000000000000000000000000000000000000000000000000000
00000000000000000000000000000000000000000000000000000000000000000000000000000000
00000000000000000000000000000000000000000000000000000000000000000000000000000000
00000000000000000000000000000000000000000000000000000000000000000000000000000000
00000000000000000000000000000000000000000000000000000000000000000000000000000000
00000000111111111111111111111111111111111111111111000000000000000000000000000000
00000000100000000000000000000000000000000000000000111111111111111111110000000000
00000000100000000000000000000000000000000000000000100000000000000000010000000000
00000000100000000000000000000000000000000000000000100000000000000000010000000000
00000000100000000000000000000000000000000000000000100000000000000000010000000000
00000000100001111111111111111111111111111111111111100000000000000000010000000000
00000000100001000000000000000000000000000000000000000000000000000000010000000000
00000000100001000000000000000000000000000000000000000000000000000000010000000000
00000000100001000011111111100000000000000000000000000000000000000000010000000000
00000000100001000010000000100000000000000000000000000000000000000000010000000000
00000000100001000010000000100000000000000000000000000000000000000000010000000000
00000000100001000010000001111111111111111111111111111111111111110011100000000000
00000000100001000010000001000000000000000000000000000011100000000000100000000000
00000000100001000010000001000000000000000000000000000010100000000000100000000000
00000000100001000010000001000000000000000000000000000010100000000000100000000000
00000000100001000010000001000011111111111111111100000010100000000000100000000000
00000000100001000010000001000010000000000000000011001110100000000000100000000000
00000000100001000010000001000010000000000000000010000000100000000000100000000000
00000000100001000010000001000010000000000000000010000000100000000000100000000000
00000000100001000010000001000011100000000000000010000000100000000000100000000000
00000000100001000010000001000000010000000000000010000000100000000000100000000000
00000000100001000010000001000000001000000000000010000000100000000000100000000000
00000000100001000010000001000000001111111111111110000000100000000000100000000000
00000000100001000010000001000000000000000000000010000000100000000000100000000000
00000000100001000010000001000000000000000000000010000000100000000000100000000000
00000000100001000011111111000000000000000000000010000000100000000000100000000000
00000000100001000000000000111111111111111111110010000000100000000000100000000000
00000000100001000000000000000000000000000000010010000000100000000000100000000000
00000000100001000000000000000000000000000000010010000000100000000000100000000000
00000000100001000000000000000000000000000000010010000000100000000000100000000000
00000000100001000000000000000000000000000000010010000000100000000000100000000000
00000000100001000000000000000000000000000000010010000000100000000000100000000000
00000000100000111111111111111111100000000000010010000000100000000000100000000000
00000000100000000000000000000000100000000000010010000000100000000000100000000000
00000000100000000000000000000000100000000000010010000000100000000000100000000000
00000000100000000000000000000000100000000000010010000000100000000000100000000000
00000000100000000000000000000000100000000000010010000000100000000000100000000000
00000000100000000000000000000000100000000000010010000000100000000000100000000000
00000000100000000000000000000000100000000000010010000000100000000000100000000000
00000000100000000000000000000000100000000000010010000000100000000000100000000000
00000000100000000000000000000000100000000000010010000000100000000000100000000000
00000000011100111111111111111111100000000000010010000000100000000000100000000000
00000000010000000000000000000000000000000000010010000000100000000000100000000000
00000000010000000000000000000000000000000000010010000000100000000000100000000000
00000000010000000000000000000000000000000000010010000000100000000000100000000000
00000000010000000000000000000000000000000000010010000000100000000000100000000000
00000000010011111111111111111111111111111111110010000000100000000000100000000000
00000000010010000000000000000000000000000000000010000000100000000000100000000000
00000000010010000000000000000000000000000000000010000000100000000000100000000000
00000000010010000000000001111111111111111111111110000000100000000000100000000000
00000000010010000000000001000000000000000000000000000000100000000000100000000000
00000000010010000000000001000000000000000000000000000000100000000000100000000000
00000000010010000000000001111111111111111111111111111111011111110000100000000000
00000000010010000000000000000000000000000000000000000100000000010000100000000000
00000000010010000000000000000000000000000000000000000100000000010000100000000000
00000000010010000000000000000000000000000000000111111000000000010000100000000000
00000000010010000000000000000000000000000000000100000000000000010000100000000000
00000000010001111111111111111111111111110000000100000000000000010000100000000000
00000000010000000000000000000000000000010000000100000000000000010000100000000000
00000000010000000000000000000000000000010000000100000000000000010000100000000000
00000000001111111111111111111111111100010000000100000000000000010000100000000000
00000000000000000000000000000000000100010000000100000000000000010000100000000000
00000000000000000000000000000000000100010000000111111111111111110000100000000000
00000000000000000000000000000000000100010000000000000000000000000000100000000000
00000000000000000000000000000000000100010000000000000000000000000000100000000000
00000000000000000000000000000000000100011111111111111111111111111111100000000000
00000000000000000000000000000000000100000000000000000000000000000000010000000000
00000000000000000000000000000000000011111111111111111111111111111111100000000000
00000000000000000000000000000000000000000000000000000000000000000000000000000000
00000000000000000000000000000000000000000000000000000000000000000000000000000000
00000000000000000000000000000000000000000000000000000000000000000000000000000000
00000000000000000000000000000000000000000000000000000000000000000000000000000000
00000000000000000000000000000000000000000000000000000000000000000000000000000000
00000000000000000000000000000000000000000000000000000000000000000000000000000000
00000000000000000000000000000000000000000000000000000000000000000000000000000000

eau
00000000000000000000000000000000000000000000000000000000000000000000000000000000
00000000000000000000000000000000000000000000000000000000000000000000000000000000
00000000000000000000000000000000000000000000000000000000000000000000000000000000
00000000000000000000000000000000000000000000000000000000000000000000000000000000
00000000000000000000000000000000000000000000000000000000000000000000000000000000
00000000011111111111111111111111111111111111111111000000000000000000000000000000
00000000100000000000000000000000000000000000000000111111111111111111100000000000
00000000100000000000000000000000000000000000000000100000000000000000010000000000
00000000100000000000000000000000000000000000000000100000000000000000010000000000
00000000100000000000000000000000000000000000000000100000000000000000010000000000
00000000100001111111111111111111111111111111111111100000000000000000010000000000
00000000100001000000000000000000000000000000000000000000000000000000010000000000
00000000100001000000000000000000000000000000000000000000000000000000010000000000
00000000100001000011111111100000000000000000000000000000000000000000010000000000
00000000100001000010000001100000000000000000000000000000000000000000010000000000
00000000100001000010000010100000000000000000000000000000000000000000010000000000
00000000100001000010000010111111111111111111111111111111111111110000010000000000
00000000100001000010000010000000000000000000000000000011100000000000010000000000
00000000100001000010000010000000000000000000000000000010100000000000010000000000
00000000100001000010000010000000000000000000000000000010100000000000010000000000
00000000100001000010000010000011111111111111111100000010100000000000010000000000
00000000100001000010000010000010000000000000000011001110100000000000010000000000
00000000100001000010000010000010000000000000000010000000100000000000010000000000
00000000100001000010000010000011100000000000000010000000100000000000010000000000
00000000100001000010000010000000010000000000000010000000100000000000010000000000
00000000100001000010000010000000001000000000000010000000100000000000010000000000
00000000100001000010000010000000000111111111111110000000100000000000010000000000
00000000100001000010000010000000000000000000000010000000100000000000010000000000
00000000100001000010000010000000000000000000000010000000100000000000010000000000
00000000100001000011111110000000000000000000000010000000100000000000010000000000
00000000100001000000000000000000000000000000000010000000100000000000010000000000
00000000100001000000000000111111111111111111110010000000100000000000010000000000
00000000100001000000000000000000000000000000010010000000100000000000010000000000
00000000100001000000000000000000000000000000010010000000100000000000010000000000
00000000100001000000000000000000000000000000010010000000100000000000010000000000
00000000100001000000000000000000000000000000010010000000100000000000010000000000
00000000100001000000000000000000000000000000010010000000100000000000010000000000
00000000100001111111111111111111100000000000010010000000100000000000010000000000
00000000100000000000000000000000100000000000010010000000100000000000010000000000
00000000100000000000000000000000100000000000010010000000100000000000010000000000
00000000100000000000000000000000100000000000010010000000100000000000010000000000
00000000100000000000000000000000100000000000010010000000100000000000010000000000
00000000100000000000000000000000100000000000010010000000100000000000010000000000
00000000100000000000000000000000100000000000010010000000100000000000010000000000
00000000100000000000000000000000100000000000010010000000100000000000010000000000
00000000100000000000000000000000100000000000010010000000100000000000010000000000
00000000011100111111111111111111100000000000010010000000100000000000010000000000
00000000010000000000000000000000000000000000010010000000100000000000010000000000
00000000010000000000000000000000000000000000010010000000100000000000010000000000
00000000010000000000000000000000000000000000010010000000100000000000010000000000
00000000010000000000000000000000000000000000010010000000100000000000010000000000
00000000010011111111111111111111111111111111110010000000100000000000010000000000
00000000010010000000000000000000000000000000000010000000100000000000010000000000
00000000010010000000000000000000000000000000000010000000100000000000010000000000
00000000010010000000000001111111111111111111111110000000100000000000010000000000
00000000010010000000000001000000000000000000000000000000100000000000010000000000
00000000010010000000000001000000000000000000000000000000100000000000010000000000
00000000010010000000000000111111111111111111111111111111111111110000010000000000
00000000010010000000000000000000000000000000000000000100000000010000010000000000
00000000010010000000000000000000000000000000000000000100000000010000010000000000
00000000010010000000000000000000000000000000000111111000000000010000010000000000
00000000010010000000000000000000000000000000000100000000000000010000010000000000
00000000010001111111111111111111111111110000000100000000000000010000010000000000
00000000010000000000000000000000000000010000000100000000000000010000010000000000
00000000010000000000000000000000000000010000000100000000000000010000010000000000
00000000001111111111111111111111111100010000000100000000000000010000010000000000
00000000000000000000000000000000000100010000000111111111111111110000010000000000
00000000000000000000000000000000000100010000000000000000000000000000010000000000
00000000000000000000000000000000000100010000000000000000000000000000010000000000
00000000000000000000000000000000000100010000000000000000000000000000010000000000
00000000000000000000000000000000000100011111111111111111111111111111100000000000
00000000000000000000000000000000000100000000000000000000000000000000110000000000
00000000000000000000000000000000000011111111111111111111111111111111100000000000
00000000000000000000000000000000000000000000000000000000000000000000000000000000
00000000000000000000000000000000000000000000000000000000000000000000000000000000
00000000000000000000000000000000000000000000000000000000000000000000000000000000
00000000000000000000000000000000000000000000000000000000000000000000000000000000
00000000000000000000000000000000000000000000000000000000000000000000000000000000
00000000000000000000000000000000000000000000000000000000000000000000000000000000
00000000000000000000000000000000000000000000000000000000000000000000000000000000

//
spawn
-2000
-2000
-100
-100
-50
-50
new
//
caisses

-100
-100
//
barrels

-100
-100
barrel
//
arrivee
580
890
//
bossentry
0
0
//
jetpacks

0
0
//